-4.260426e+00 9.355788e+00 9.355788e+00 -4.260426e+00
8.110294e+00 9.355788e+00 9.355788e+00 8.110294e+00
-1.431946e+00 9.355788e+00 9.355788e+00 -1.431946e+00
-3.389185e+00 9.355788e+00 9.355788e+00 -3.389185e+00
1.268873e+01 9.355788e+00 9.355788e+00 1.268873e+01
1.256588e+01 9.355788e+00 9.355788e+00 1.256588e+01
1.147124e+01 9.355788e+00 9.355788e+00 1.147124e+01
1.075296e+01 9.355788e+00 9.355788e+00 1.075296e+01
1.956892e+01 9.355788e+00 9.355788e+00 1.956892e+01
1.142355e+01 9.355788e+00 9.355788e+00 1.142355e+01
1.112559e+01 9.355788e+00 9.355788e+00 1.112559e+01
1.600559e+01 9.355788e+00 9.355788e+00 1.600559e+01
1.787704e+01 9.355788e+00 9.355788e+00 1.787704e+01
3.322480e+00 9.355788e+00 9.355788e+00 3.322480e+00
1.570689e+01 9.355788e+00 9.355788e+00 1.570689e+01
2.221018e+01 9.355788e+00 9.355788e+00 2.221018e+01
1.054665e+01 9.355788e+00 9.355788e+00 1.054665e+01
4.462134e+01 9.355788e+00 9.355788e+00 4.462134e+01
8.553948e+00 9.355788e+00 9.355788e+00 8.553948e+00
3.024678e+00 9.355788e+00 9.355788e+00 3.024678e+00
1.370021e+01 9.355788e+00 9.355788e+00 1.370021e+01
2.415424e+00 9.355788e+00 9.355788e+00 2.415424e+00
1.170105e+01 9.355788e+00 9.355788e+00 1.170105e+01
-3.367362e+00 9.355788e+00 9.355788e+00 -3.367362e+00
5.677027e+00 9.355788e+00 9.355788e+00 5.677027e+00
